00000000000000000000000000
01010011111111111111000010
01111110000000011001101010
01000000111111010000111000
01111110000101010100001111
01000000010101111111001000
01011011100100100001001010
01000010111101101001111010
01111110010001000000100010
01000100111001011111100100
01110000101001010000111111
01010110101111111110000100
01000100111010001010000000
01111101100010101111111100
01000001000010100000000000